0000000000000000000000000000000000000000000000
0000000000000000000000000000000000000000000000
0000000000000000000000000000000000000000000000
0000000000000000000000000000000000000000000000
0000000000000000000000000000000000000000000000
0000000000000000000000000000000000000000000000
0000000000000000000000000000000000000000000000
0000000000000000000000000000000000000000000000
1111111111111111111111000011111111111000000000
1111111111111111111111111111111111111111111111
0000000000051152222511111111152222221111111111
0000000000225115222225222222222222222000000111
0000000002222511252222222225352222222000000000
0000000002222511525222232222222222220000000000
0000000002222251122222222222222222200000000000
0000000002222225115222252222222322000000000000
0000000000222222511552222222222222200000000000
0000000000022222511111411152222222220000000000
0000000000025222111115251111522222300000000000
0000000000222225115522222511115252250000000000
0000000005222222112222222225111522000000000000
0000000002222222112225222222511152000000000000
0000000002222225112252222222221111000000000000
0000000002222251152222222222225111111000000000
0000000002222221125222222222222511111111111111
0000000002225224422222322222222222001111111111
0000000002222211322222222222222222500001111111
0000000002222211222222222222225223250000000000
0000000000255115522252252252222222222000000000
0000000000111122222222232222222522222000000000
1111111111152252222222233252222222222000000000
0000000000222222222222222222222222522000000000
0000000000222222222222522222222222222000000000
0000000000052222322222225222222222232000000000
0000000000222222222222225322222222222000000000
0000000002232222222222222222322222322000000000
0000000000225223252222222222222222222000000000
0000000000022222222220000000222222200000000000
0000000000000000000000000000000000000000000000
0000000000000000000000000000000000000000000000
0000000000000000000000000000000000000000000000
0000000000000000000000000000000000000000000000
0000000000000000000000000000000000000000000000
0000000000000000000000000000000000000000000000
0000000000000000000000000000000000000000000000
0000000000000000000000000000000000000000000000